-1;-1;-1;-1;-1;-1;-1;-1;-1;-1
-1;-1;-1;-1;-1;-1;-1;-1;-1;-1
-1;-1;-1;-1;-1;-1;-1;-1;20;-1
-1;-1;-1;-1;17;-1;-1;10;12;-1
-1;15;-1;-1;10;12;-1;-1;-1;-1
-1;10;12;-1;-1;-1;-1;-1;-1;-1
-1;-1;-1;-1;-1;-1;-1;-1;-1;-1
-1;-1;-1;-1;10;11;11;12;-1;-1
-1;3;4;-1;-1;-1;-1;-1;-1;-1
-1;5;7;-1;-1;-1;-1;-1;-1;-1
0;2;7;-1;-1;-1;-1;-1;-1;3
6;6;7;-1;-1;-1;-1;-1;-1;5
6;6;7;-1;-1;-1;-1;-1;3;2
6;6;7;-1;21;-1;24;15;5;6
6;6;8;9;1;1;1;0;2;6
6;6;6;6;6;6;6;6;6;6
