-1;-1;-1;-1;-1;-1;-1;-1;-1;-1
-1;-1;-1;-1;-1;-1;-1;-1;-1;-1
-1;-1;-1;-1;-1;-1;-1;-1;-1;-1
-1;-1;-1;-1;-1;-1;-1;-1;-1;-1
-1;-1;-1;-1;-1;-1;-1;-1;-1;-1
-1;-1;-1;-1;-1;-1;-1;-1;-1;-1
-1;-1;-1;-1;-1;-1;-1;-1;-1;-1
-1;-1;-1;-1;-1;-1;-1;-1;-1;-1
-1;15;24;-1;-1;-1;-1;24;-1;-1
-1;3;4;-1;-1;-1;3;4;19;-1
0;2;7;-1;-1;-1;5;8;9;1
6;6;7;-1;-1;-1;5;6;6;6
6;6;7;-1;-1;-1;5;6;6;6
6;6;7;-1;-1;-1;5;6;6;6
6;6;7;-1;-1;-1;5;6;6;6
6;6;7;-1;-1;-1;5;6;6;6
