-1;-1;-1;-1;-1;-1;-1;-1;-1;-1
-1;-1;-1;-1;-1;-1;-1;-1;-1;-1
-1;-1;-1;-1;-1;-1;-1;-1;-1;-1
-1;-1;-1;-1;-1;-1;-1;-1;-1;-1
-1;-1;-1;-1;-1;-1;-1;-1;-1;-1
-1;-1;-1;-1;-1;-1;-1;-1;-1;-1
-1;-1;-1;-1;-1;-1;-1;-1;-1;-1
-1;19;-1;15;-1;-1;-1;-1;-1;-1
-1;3;1;4;-1;-1;-1;-1;-1;-1
-1;5;6;7;-1;-1;-1;-1;-1;-1
0;2;6;7;-1;-1;24;17;3;1
6;6;6;7;-1;-1;3;1;2;6
6;6;6;7;-1;19;5;6;6;6
6;6;6;8;9;0;2;6;6;6
6;6;6;6;6;6;6;6;6;6
6;6;6;6;6;6;6;6;6;6
