-1;-1;-1;-1;-1;-1;-1;-1;-1;-1
-1;-1;-1;-1;-1;-1;-1;-1;-1;-1
-1;-1;-1;-1;-1;-1;-1;-1;-1;-1
-1;-1;-1;-1;-1;-1;-1;-1;-1;-1
-1;-1;-1;-1;-1;-1;-1;-1;-1;-1
-1;-1;-1;-1;-1;-1;21;24;-1;-1
-1;21;-1;19;-1;10;11;11;12;-1
10;11;11;12;-1;-1;-1;-1;-1;-1
-1;-1;-1;-1;-1;-1;-1;20;-1;-1
-1;-1;-1;-1;-1;3;1;4;-1;-1
1;1;1;1;0;2;6;8;9;1
6;6;6;6;6;6;6;6;6;6
6;6;6;6;6;6;6;6;6;6
6;6;6;6;6;6;6;6;6;6
6;6;6;6;6;6;6;6;6;6
6;6;6;6;6;6;6;6;6;6
