-1;-1;-1;-1;-1;-1;-1;-1;-1;-1
-1;-1;-1;-1;-1;-1;-1;-1;-1;-1
-1;-1;-1;-1;-1;-1;-1;-1;-1;-1
-1;-1;-1;-1;-1;-1;-1;-1;-1;-1
-1;-1;-1;-1;-1;-1;-1;-1;-1;-1
-1;-1;-1;-1;-1;-1;-1;-1;-1;-1
-1;-1;-1;-1;-1;-1;-1;-1;-1;-1
-1;-1;-1;24;-1;-1;18;-1;-1;-1
-1;-1;10;12;-1;-1;10;12;-1;-1
-1;-1;-1;-1;-1;-1;-1;-1;-1;-1
1;14;14;14;14;14;14;14;14;1
6;13;13;13;13;13;13;13;13;6
6;13;13;13;13;13;13;13;13;6
6;13;13;13;13;13;13;13;13;6
6;13;13;13;13;13;13;13;13;6
6;6;6;6;6;6;6;6;6;6
