-1;-1;-1;-1;-1;-1;-1;-1;-1;-1
-1;-1;-1;-1;-1;-1;-1;-1;-1;-1
-1;-1;-1;-1;-1;-1;-1;-1;-1;-1
-1;-1;-1;-1;-1;-1;-1;-1;-1;-1
-1;-1;20;-1;-1;-1;-1;-1;-1;-1
-1;10;12;-1;-1;-1;21;24;-1;-1
-1;-1;-1;-1;-1;10;11;12;-1;-1
-1;-1;17;24;-1;-1;-1;-1;-1;-1
-1;-1;10;12;-1;-1;-1;-1;-1;-1
-1;-1;-1;-1;-1;-1;15;-1;-1;-1
4;-1;-1;-1;-1;10;12;-1;-1;3
7;-1;-1;-1;-1;-1;-1;20;-1;5
7;-1;-1;-1;-1;-1;-1;3;0;2
8;9;4;-1;-1;3;0;2;6;6
6;6;7;-1;-1;5;6;6;6;6
6;6;7;-1;-1;5;6;6;6;6
