-1;-1;-1;-1;-1;-1;-1;-1;-1;-1
-1;-1;-1;-1;-1;-1;-1;-1;-1;-1
-1;-1;-1;-1;-1;-1;-1;-1;-1;-1
-1;-1;-1;-1;-1;-1;-1;-1;-1;-1
-1;-1;20;-1;-1;-1;-1;-1;-1;-1
-1;10;11;12;-1;-1;-1;21;24;-1
-1;-1;-1;-1;-1;24;-1;3;4;-1
-1;-1;-1;-1;16;3;0;2;7;-1
-1;-1;-1;3;0;2;6;6;7;-1
-1;3;0;2;6;6;6;6;7;-1
0;2;6;6;6;6;6;6;8;9
6;6;6;6;6;6;6;6;6;6
6;6;6;6;6;6;6;6;6;6
6;6;6;6;6;6;6;6;6;6
6;6;6;6;6;6;6;6;6;6
6;6;6;6;6;6;6;6;6;6
