-1;-1;-1;-1;-1;-1;-1;-1;-1;-1
-1;-1;-1;-1;-1;-1;-1;-1;-1;-1
-1;-1;-1;-1;-1;-1;-1;-1;-1;-1
-1;-1;-1;-1;-1;-1;-1;-1;-1;-1
-1;-1;-1;-1;-1;-1;-1;-1;-1;-1
4;-1;-1;-1;-1;-1;-1;-1;-1;-1
7;-1;-1;-1;-1;-1;-1;-1;-1;-1
7;-1;-1;-1;-1;-1;-1;-1;-1;-1
7;-1;-1;-1;-1;-1;-1;-1;-1;-1
7;17;22;21;-1;-1;-1;-1;-1;-1
8;9;1;1;4;-1;-1;-1;-1;3
6;6;6;6;7;15;24;-1;16;5
6;6;6;6;8;9;1;1;0;2
6;6;6;6;6;6;6;6;6;6
6;6;6;6;6;6;6;6;6;6
6;6;6;6;6;6;6;6;6;6
