-1;-1;-1;-1;-1;-1;-1;-1;-1;-1
-1;-1;-1;-1;-1;-1;-1;-1;-1;-1
-1;-1;-1;-1;-1;-1;-1;-1;-1;-1
-1;-1;-1;-1;-1;-1;-1;-1;-1;-1
-1;-1;-1;-1;-1;-1;-1;-1;-1;-1
-1;-1;-1;-1;-1;-1;-1;-1;-1;-1
-1;-1;-1;-1;-1;-1;-1;-1;-1;-1
-1;-1;-1;-1;-1;-1;-1;-1;-1;-1
-1;-1;-1;-1;16;24;-1;-1;-1;-1
-1;-1;-1;-1;3;4;-1;-1;-1;-1
1;14;14;0;2;8;9;14;14;1
6;13;13;6;6;6;6;13;13;6
6;13;13;6;6;6;6;13;13;6
6;13;13;6;6;6;6;13;13;6
6;13;13;6;6;6;6;13;13;6
6;6;6;6;6;6;6;6;6;6
