-1;-1;-1;-1;-1;-1;-1;-1;-1;-1
-1;-1;-1;-1;-1;-1;-1;-1;-1;-1
-1;-1;-1;-1;-1;-1;-1;-1;-1;-1
-1;-1;-1;-1;-1;-1;-1;-1;19;15
-1;-1;-1;-1;21;-1;-1;10;11;12
-1;15;-1;10;11;11;12;-1;-1;-1
10;12;-1;-1;-1;-1;-1;-1;-1;-1
-1;-1;24;-1;-1;-1;-1;-1;-1;-1
-1;3;1;1;1;4;18;-1;-1;-1
-1;5;6;6;6;8;9;4;-1;-1
0;2;6;6;6;6;6;8;9;1
6;6;6;6;6;6;6;6;6;6
6;6;6;6;6;6;6;6;6;6
6;6;6;6;6;6;6;6;6;6
6;6;6;6;6;6;6;6;6;6
6;6;6;6;6;6;6;6;6;6
