-1;-1;-1;-1;-1;-1;-1;-1;-1;-1
-1;-1;-1;-1;-1;-1;-1;-1;-1;-1
-1;-1;-1;-1;-1;-1;-1;-1;-1;-1
-1;-1;-1;-1;-1;-1;-1;-1;-1;-1
-1;-1;-1;-1;-1;-1;-1;-1;-1;-1
-1;-1;-1;-1;-1;-1;-1;-1;-1;-1
-1;-1;-1;-1;-1;-1;-1;-1;-1;-1
-1;-1;-1;-1;-1;-1;-1;-1;-1;-1
-1;-1;-1;-1;-1;-1;-1;-1;-1;-1
-1;17;-1;-1;24;16;-1;-1;-1;-1
1;4;-1;15;3;4;-1;19;3;1
6;8;9;0;2;8;9;0;2;6
6;6;6;6;6;6;6;6;6;6
6;6;6;6;6;6;6;6;6;6
6;6;6;6;6;6;6;6;6;6
6;6;6;6;6;6;6;6;6;6
