-1;-1;-1;-1;-1;-1;-1;-1
-1;-1;-1;-1;-1;-1;-1;-1
-1;-1;-1;-1;-1;-1;-1;-1
-1;-1;-1;-1;-1;-1;-1;-1
-1;-1;-1;-1;-1;3;4;-1
-1;-1;-1;-1;-1;5;7;-1
-1;-1;-1;-1;-1;5;7;-1
-1;-1;-1;-1;-1;5;7;-1
-1;-1;-1;-1;-1;5;7;-1
-1;21;-1;23;-1;5;8;4
1;1;1;1;0;2;6;7
6;6;6;6;6;6;6;7
6;6;6;6;6;6;6;7
6;6;6;6;6;6;6;7
6;6;6;6;6;6;6;7
6;6;6;6;6;6;6;7
