-1;-1;-1;-1;-1;-1;-1;-1;-1;-1
-1;-1;-1;-1;-1;-1;-1;-1;-1;-1
-1;-1;-1;-1;-1;-1;-1;-1;-1;-1
-1;-1;-1;-1;-1;-1;-1;-1;-1;-1
-1;-1;-1;-1;-1;-1;-1;-1;-1;-1
-1;-1;-1;-1;-1;-1;-1;-1;-1;-1
-1;-1;-1;-1;-1;-1;-1;-1;-1;-1
-1;-1;-1;-1;-1;-1;-1;-1;-1;-1
-1;-1;-1;-1;15;19;-1;-1;-1;-1
-1;21;-1;-1;10;12;-1;-1;24;-1
1;1;4;-1;-1;-1;-1;3;1;1
6;6;7;-1;-1;-1;-1;5;6;6
6;6;7;-1;-1;-1;-1;5;6;6
6;6;7;-1;-1;-1;-1;5;6;6
6;6;7;-1;-1;-1;-1;5;6;6
6;6;7;-1;-1;-1;-1;5;6;6
