-1;-1;-1;-1;-1;-1;-1;-1;-1;-1
-1;-1;-1;-1;-1;-1;-1;-1;-1;-1
-1;-1;-1;-1;-1;-1;-1;-1;-1;-1
-1;-1;-1;-1;-1;-1;16;24;-1;-1
-1;-1;-1;-1;-1;-1;10;12;-1;-1
-1;-1;-1;-1;-1;-1;-1;-1;-1;-1
-1;-1;-1;-1;10;11;12;-1;-1;-1
-1;-1;15;-1;20;-1;-1;-1;-1;-1
-1;-1;10;11;11;12;-1;-1;-1;-1
-1;-1;-1;-1;-1;-1;-1;-1;18;-1
0;4;14;14;14;14;14;14;3;1
6;6;13;13;13;13;13;13;6;6
6;6;13;13;13;13;13;13;6;6
6;6;13;13;13;13;13;13;6;6
6;6;13;13;13;13;13;13;6;6
6;6;6;6;6;6;6;6;6;6
