-1;-1;-1;-1;-1;-1;-1;-1;-1;-1
-1;-1;-1;-1;-1;-1;-1;-1;-1;-1
-1;-1;-1;-1;-1;-1;-1;-1;20;-1
-1;-1;18;-1;-1;10;12;-1;3;4
-1;-1;10;12;-1;-1;-1;-1;5;7
-1;-1;-1;-1;-1;24;-1;-1;5;7
-1;-1;15;-1;10;12;-1;-1;5;7
-1;10;12;-1;-1;-1;-1;-1;5;7
-1;-1;-1;-1;-1;-1;-1;-1;5;7
-1;-1;10;12;-1;10;12;-1;5;7
4;-1;-1;-1;-1;-1;-1;-1;5;8
7;-1;-1;-1;-1;-1;-1;-1;5;6
6;14;14;14;14;14;14;14;6;6
6;13;13;13;13;13;13;13;6;6
6;13;13;13;13;13;13;13;6;6
6;6;6;6;6;6;6;6;6;6
